{
    "name":"default",
    "images":[
        "map.png"
    ],
    "frameSize":{
        "width":10,
        "height":10
    },
    "mapSize":{
        "width":10,
        "height":10
    },
    "cellDefinitions":[
        "agua",
        "tierra"
    ],
    "map":[
        [0,1,0,1,0,1,0,1,0,1],
        [1,0,1,0,1,0,1,0,1,0],
        [0,1,0,1,0,1,0,1,0,1],
        [1,0,1,0,1,0,1,0,1,0],
        [0,1,0,1,0,1,0,1,0,1],
        [1,0,1,0,1,0,1,0,1,0],
        [0,1,0,1,0,1,0,1,0,1],
        [1,0,1,0,1,0,1,0,1,0],
        [0,1,0,1,0,1,0,1,0,1],
        [1,0,1,0,1,0,1,0,1,0]
    ]
}